00,00,00,00,99,00,00,00,00,00,00,00,00,00,99,00,00,00,00,00,
00,00,00,00,99,00,00,00,00,00,00,00,00,00,99,00,00,00,00,00,
00,00,00,00,99,00,00,00,00,00,00,00,00,00,99,00,00,00,00,00,
00,00,00,00,99,00,00,00,00,00,00,00,00,00,99,00,00,00,00,00,
00,00,00,00,99,00,00,00,00,00,00,00,00,00,99,00,00,00,00,00,
00,00,00,00,99,00,00,00,99,99,99,99,99,99,99,00,00,99,99,99,
00,00,00,00,00,00,00,00,00,00,00,00,00,00,00,00,00,00,00,00,
00,00,00,00,00,00,00,00,00,00,00,00,00,00,00,00,00,00,00,00,
00,00,00,00,00,00,00,00,00,00,00,00,00,00,99,99,99,99,00,00,
00,00,00,00,99,00,00,00,00,00,00,00,00,00,99,99,99,99,00,00,
99,99,00,00,99,00,00,00,00,00,00,00,00,00,99,99,99,99,00,00,
99,99,00,00,99,00,00,00,00,00,00,00,00,00,00,00,00,00,00,00,
99,99,00,00,99,00,00,99,99,99,99,00,00,00,00,00,00,00,00,00,
99,99,00,00,99,00,00,99,99,99,99,00,00,00,00,00,00,00,00,00,
00,00,00,00,99,00,00,99,99,99,99,00,00,00,00,00,00,00,00,00,
00,00,00,00,99,00,00,00,00,00,00,00,00,00,00,00,00,00,00,00,
00,00,00,00,99,00,00,00,00,00,00,00,00,00,00,99,99,99,99,99,
00,00,00,00,99,00,00,00,00,00,00,00,00,00,00,99,99,99,99,99,
00,00,00,00,99,00,00,00,00,00,00,00,00,00,00,99,99,99,99,99,
00,00,00,00,99,00,00,00,00,00,00,00,00,00,00,99,99,99,99,99,